1111111111111
10010000000C1
10C0011111001
10P011E000001
1111111111111
