K111111111111
1CCCCC1ECCCC1
1C111C111C1C1
1C1CCC1C1C1C1
1C1C111C111C1
1C1CC11C1CCC1
1P0CCCCCCCCC1
1111111111111
1111111111111
1111111111111
